2111111111111111111111111111111111111111111111111111112
1000000000000000000000000000000000000000000000000000001
1000000000000000000000000000000000000000000000000000001
1000000000000000000000000000000000000000000000000000001
1000000000001000000000000000000000000000000000000000001
1000000000001000000000000000000000000000000000000000001
1000000000001000000000000000000000000000000000000000001
1000000111112111110000000000000000000000000000000000001
1000000000001000000000000000000000000000000000000000001
1000000000001000000000000000000000000000000000000000001
1000000000001000000000000000000000000000000000000000001
1000000000000000000000000000000000000000000000000000001
1000000000000000000000000000000000000000000000000000001
1000000000000000000000000000000000000000000000000000001
1000000000000000000000000000000000000000010000000000001
1000000000000000000000000000000000000000010000000000001
1000000000000000000000000000000000000000010000000000001
1000000000000000000000000000000000001111121111100000001
1000000000000000000000000000000000000000010000000000001
1000000000000000000000000000000000000000010000000000001
1000000000000000000000000000000000000000010000000000001
1000000000000000000000000000000000000000000000000000001
1000000000000000000000000000000000000000000000000000001
1000000000000000000000000000000000000000000000000003001
2111111111111111111111111111111111111111111111111111112